11111
10001
1C001
11E11
10P11
11111