111111
1PC001
1P0E01
1P0E01
111111
