11111
100E1
1C001
11011
10P11
1111