11111
100E1
1C001
10001
10P11
1111
