11111111111111111111
100000000E0000000001
10000000C00000000001
100000C0000000000001
10000000000000000001
100C0000000000000001
1P000000000000000001
11111111111111111111
