11111
100E1
10001
10001
10PC1
11111
