11111111111111
10010C00000C01
10000111110001
1P0011E0000001
11111111111111
